XXXXXXXXXXXXXXXXXXXXXX
XXX                 XX
XXX XXXXXXXXXXX X X XX
XX  X     XXXXX X X XX
XXX X X X     X X XXXX
XXX X X X XXXXX X   XX
XXX XXX X X     XX XXX
XX      X X XXXXXX XXX
XXXXXXXXX X   X     XX
XS        XXXXXXXX XXX
XXXXXXXXXXX         XX
XXX       XXXXXX XXXXX
XXXXXXXX         XXXXX
XXXX  XXXXXXX XXXXXXXX
XXX               XXXX
XXXXXXXXXXXXXXX XXXXXX
XX            X   X XX
XX XX XX XXXXXX XXX XX
XX  X X             XX
XXXXX XXX XXXXXXXXXXXX
XXX    X            XX
XXXXXXXXXXXXXXXXEXXXXX